CCCCCCCCCCCCCCCCCCCCCCCCCCC
CBBBBBBJBBCDPPRSBUWYBBBOCCC
CBBBBBBKBBCEQQBTBVXZBBB*CCC
C       LMC             CCC
C        NC       1     CCC
C         C             CCC
C         B             CCC
C2        B            2CCC
CCCCCCCC      CCCCCCCCCCCCC
CCDDDBBB   1  BBBBBBBBBBCCC
CCEEEBBB      BBIBBBBHGFCCC
CC                2     CCC
CC                 L    CCC
CC                      CCC
CC   2                 oCCC
CCCCCCCCCCCCCCCCCCCCCCCCCCC
CCCCCCCCCCCCCCCCCCCCCCCCCCC
BBBBBBBBBBBBBBBBBBBBBBBBBBB
BBBBBBBBBBBBBBBBBBBBBBBBBBB
BBBBBBBBBBBBBBBBBBBBBBBBBBB
