CC     CCCCCCCCCCCCCCCCCC
C                      C
C                      C
C      LMC             C
C       NC             C
C        B             C
C        B             C
CCCCCCC      CCCCCCCCCCC
CBBBBBB      BBBBBBBBBBC
CBBBBBB      BBB0?BB¿@!C
C 357                  C
C 468             L    C
C  9                   C
C                      C
CCCCCCCCCCCCCCCCCCCCCCCC
BBBBBBBBBBBBBBBBBBBBBBBB
BBBBBBBBBBBBBBBBBBBBBBBB


