CC  CCCCCCCCCCCCCCCCCCCCCCC
C     BJBBCDPPRSBUWYBBBOCCC
C     BKBBCEQQBTBVXZBBB*CCC
C       LMC             CCC
C        NC             CCC
C         C             CCC
C         B             CCC
C2        B            2CCC
CCCCCCCC      CCCCCCCCCCCCC
CCDDDBBB      BBBBBBBBBBCCC
CCEEEBBB      BBIBBBBHGFCCC
CC                2     CCC
CC                 L    CCC
CC                      CCC
CC   2                  CCC
CCCCCCCCCCCCCCCCCCCCCCCCCCC
CCCCCCCCCCCCCCCCCCCCCCCCCCC
BBBBBBBBBBBBBBBBBBBBBBBBBBB
BBBBBBBBBBBBBBBBBBBBBBBBBBB
BBBBBBBBBBBBBBBBBBBBBBBBBBB
