CC  CCCCCCCCCCCCCCCCCCCCCCC
C     BJBBCDPPRSBUWYBBBOCCC
C     BKBBCEQQBTBVXZBBB*CCC
C       LMC             CCC
C        NC             CCC
C         C             CCC
C         B             CCC
C         B             CCC
CCCCCCCC      CCCCCCCCCCCCC
CCDDDBBB      BBBBBBBBBBCCC
CCEEEBBB      BBIBBBBHGFCCC
CC                      CCC
CC                 L    CCC
CC                      CCC
CC                      CCC
CCCCCCCCCCCCCCCCCCCCCCCCCCC
CCCCCCCCCCCCCCCCCCCCCCCCCCC
BBBBBBBBBBBBBBBBBBBBBBBBBBB
BBBBBBBBBBBBBBBBBBBBBBBBBBB
BBBBBBBBBBBBBBBBBBBBBBBBBBB
