CC  CCCCCCCCCCCCCCCCCCCCCCC
C     BJBBC  PRSBUWYBBBOCCC
C     BKBBCEQQBTBVXZBBB*CCC
C                       CCC
C                       CCC
C                       CCC
C                       CCC
C                       CCC
C                       CCC
C                       CCC
C                       CCC
C                       CCC
C                       CCC
CCCCCCCCCCCCCCCCCCCCCCCCCCC
CCCCCCCCCCCCCCCCCCCCCCCCCCC
BBBBBBBBBBBBBBBBBBBBBBBBBBB
BBBBBBBBBBBBBBBBBBBBBBBBBBB
BBBBBBBBBBBBBBBBBBBBBBBBBBB
