CCCCCCCCCCCCCCCCCCCCCCCCCCCCCCCCCCCCCCCCCCCCCCCCCCCCCCCCCCCC
CBBBBBBBSBBBBBBBBBBBBBBBBBBBRBBBBBBBBBBBBBBBBBBBBBBBBBBBBBOC
CBBBBBBBTBIBBBBBBBBBBBBBBBBBBBBBBBBBBBBBBBBBBBBFGHBBBBBBBB*C
C                 2                                        C
C                           L                 2            C
C                               1                          C
CCCCCCCCCCCCCCCCCCCCCCCC         CCCCCCCCCCCCCCCCCCCCCCCCCCC
CBBBBBBBBBBBBBBJBBBBBBBB         BBBBBBBBBBBBBBBBBBBBBBBBBBC
CBBBBBBBBBBBBBBKBBBBBBBB         BBBBBBBBBBBBBBBBBBBBBBBBBBC
C 1                                            2           C
C                     1                                  2 C
CCCCCCCCCCCCCCCCCCCCCCCC         CCCCCCCCCCCCCCCCCCCCCC    C
CBBBBUWYBBBBBBBBBBBBBBBB         BBBBBPBBBBBCPPDBBBBBBB    C
CBBBBVXZBBBBBBBBBBBBBBBB         BBBBBQBBBBBCQQEBBBBBBB    C
C                                          MC              C
C                                          NC              C
C1                     C              2     C      2       C
Co                     C         1          C              C
C       2              C                    C              C
CCCCCCCCCCCCCCCCCCCCCCCCCCCCCCCCCCCCCCCCCCCCCCCCCCCCCCCCCCCC
CCCCCCCCCCCCCCCCCCCCCCCCCCCCCCCCCCCCCCCCCCCCCCCCCCCCCCCCCCCC
BBBBBBBBBBBBBBBBBBBBBBBBBBBBBBBBBBBBBBBBBBBBBBBBBBBBBBBBBBBB
BBBBBBBBBBBBBBBBBBBBBBBBBBBBBBBBBBBBBBBBBBBBBBBBBBBBBBBBBBBB
BBBBBBBBBBBBBBBBBBBBBBBBBBBBBBBBBBBBBBBBBBBBBBBBBBBBBBBBBBBB
